2222222222222222222222222222222222
210$000000002000000000000000020002
2000000000002000000000000000020002
2$00222200002002222222000002220002
2000200200002000000022000000000202
2000200220000000000020000000000202
2000200022222000000020000000000202
2000200000000000000022000222222202
2000200000002000000022000000000202
2000200000002000000022000000000202
2222222222222222222222222222222232
