222222222222222222222222
210000000000200000000002
200000000000200000000002
200022220000200222222202
200020020000200000002202
200020022000000000002202
200020002222200000002202
200020000000000000002202
200020000000200000002202
200020000000200000002202
222222222222222222222232
