2222222222222222222222222222222222
210$000000000000000000000000020002
2000000000002000000000000000020002
2000000000002002222222200002220002
2222222222222000000022000022000002
2000200002$00000000020000020000002
2000200002222000000020000000000002
2000200000002000000022200022222222
2000200000002000000020000000000002
2000200000002000022222222000000002
2002200000222000020000002000000002
2000000000000000020000002000000002
2000022222222200020000002000000202
2000020000000200020000002000000202
2000020000000000000000000000000202
2222222222222222222222222222222232
