2222222222222222222222222222222222
2000000000002000000000200000000212
2000000000002000000002200000000202
2222222222202000000000000000000202
2000000000202002222222222222222202
2000000000000000000000000000000002
2222222222222222220222220222222222
2000000200000000000200$20200000002
2000000200000000000200020200000002
2000000200000000000000020200000002
2002222202222222222222220222022222
2000000000000000000000000000000002
2222222220200222222222222222222222
2000000000200000000200000000022003
2000000000200000000000000000000002
2222222222222222222222222222222222
