2222222222222222222222222222222222
2000000000000000000000000000000002
2022022222222222222222202222222202
2022000000000000000000200000000202
2022222222222220000000200000000202
2022$00000000020000000202222222202
2022000000000020000000200000000002
2022222222220222222222222222222202
2000000000000000002222222222222202
2000002000000000200000000000000202
2222222222222222200000000000000202
300000000000000000000000000000$202
2222222222222222222222222222222202
2102000020002000200000000000000202
2000000000200020002000000000000002
2222222222222222222222222222222222
